W W W W W W W W W 
W A A W B B B B W
W A A G B B B B W
W W G W W W W G W
W C C C W D D D W
W C C C G D D D W
W W W W W W W W W